20 20
0 0
0 0 0 0 0 1 1 1 1 1 1 1 1 1 1 1 1 1 1 1
0 0 0 0 0 0 0 0 0 0 0 0 0 0 0 0 0 0 0 1
0 0 0 8 0 0 0 0 0 0 0 0 0 0 0 0 0 0 0 1
0 0 0 8 8 0 0 0 0 0 0 0 0 0 0 0 0 0 0 1
0 0 0 0 0 8 0 0 0 0 0 0 0 0 0 0 0 0 0 1
0 0 0 0 0 0 8 0 0 0 0 0 0 0 0 0 0 0 0 1
0 0 0 0 0 0 8 0 0 0 0 0 0 0 0 0 0 0 0 1
0 0 0 0 0 0 8 0 0 0 0 0 0 0 0 0 0 0 0 1
0 0 0 0 0 0 8 0 0 0 0 0 0 0 0 0 0 0 0 1
0 0 0 0 1 0 8 0 0 0 1 1 1 0 0 0 0 0 0 1
0 0 0 0 1 0 8 0 0 0 1 1 1 0 0 0 0 0 0 1
0 0 0 0 1 0 8 0 0 0 0 0 0 0 0 0 0 0 0 1
0 0 0 0 1 0 8 0 0 0 0 0 0 0 0 0 0 0 0 1
0 0 0 0 1 0 0 8 0 0 0 0 0 0 0 0 0 0 0 1
0 0 0 0 0 0 0 0 8 8 8 8 8 8 8 8 8 8 0 1
0 0 0 0 0 0 0 0 0 0 0 0 0 4 3 3 6 6 3 3 
0 0 0 0 0 0 0 0 0 0 0 0 0 5 2 2 6 6 2 2
0 0 0 0 0 0 0 0 0 0 0 0 0 5 2 2 7 7 2 2
0 0 0 0 0 0 0 0 0 0 0 0 0 5 2 2 2 2 2 2
0 0 0 0 1 1 1 1 1 1 1 1 1 5 2 2 2 2 2 2


